R  1500 750
F 101 ,  191 ,  191
C 5,225 ,225  
NO ./images/brick.xpm
SO    ./images/grey.xpm
WE   ./images/floor.xpm
EA    ./images/wood.xpm
S ./images/chest.xpm

        111111111111111111111111
        1000000000110000000000001
        101100000111000000200000111
        101100000111000000200000111
        1001000000000000000000001
111111111011000001110000000000001
100000000011000001110100011111111
11110111111111011100000000221
11110111111111011101010000001
11000000110101011100000010001
10002000000000001000011110111
100000000000000011010000000011
1100000111010101111101100N00011
11110111 1110101 1011100000011
11111111 1111111 111111111111


