R  0    0
F 191  ,  191 ,  191
C 100,225 ,225  
NO ./images/brick.xpm
SO    ./images/grey.xpm
WE   ./images/floor.xpm
EA    ./images/wood.xpm
S ./images/barrel.xpm

11111111111111111111111111111111111
10000000002222222222220000000000001
10000000000000000000000000000000001
10000022222222000000222200000000001
10000000000000000000000000000000001
10000222222222200002222200000000001
10000000000000000000000000000000001
10000000000000000000000000000000001
10000022222222220000000000000000001
10000000000000000000000000000000001
10000000000000000000000000000000001
100000000000000N0000000000000000001
11111111111111111111111111111111111

